1 1 1 1 1 1 3 3 1 1 1 1 1 1 3 3 1 1 1 1 1 1 1 1 1 1
1 1 1 1 1 1 3 3 1 1 1 1 1 1 3 3 1 1 1 1 1 1 1 1 1 1
1 1 4 4 4 4 3 3 1 1 1 1 1 1 2 2 1 1 2 2 1 1 2 2 1 1
1 1 4 4 4 4 3 3 1 1 1 1 1 1 2 2 1 1 2 2 1 1 2 2 1 1
1 1 4 4 5 5 5 5 5 5 5 5 5 5 5 5 5 5 5 5 5 5 2 2 1 1
1 1 4 4 5 5 5 5 5 5 5 5 5 5 5 5 5 5 5 5 5 5 2 2 1 1
1 1 1 1 5 5 2 2 1 1 1 1 1 1 1 1 1 1 3 3 5 5 4 4 1 1
1 1 1 1 5 5 2 2 1 1 6 6 1 1 1 1 1 1 3 3 5 5 4 4 1 1
4 4 1 1 5 5 2 2 6 6 6 6 6 6 1 1 1 1 2 2 5 5 2 2 3 3
4 4 1 1 5 5 2 2 6 6 6 6 6 6 1 1 1 1 2 2 5 5 2 2 3 3
4 4 4 4 3 3 1 1 6 6 6 6 6 6 1 1 3 3 1 1 3 3 1 1 1 1
4 4 4 4 3 3 1 1 1 1 6 6 1 1 1 1 3 3 1 1 3 3 1 1 1 1
1 1 2 2 5 5 2 2 4 4 4 4 4 4 3 3 1 1 1 1 5 5 2 2 1 1
1 1 2 2 5 5 2 2 4 4 4 4 4 4 3 3 1 1 1 1 5 5 2 2 1 1
1 1 1 1 5 5 3 3 4 4 2 2 1 1 2 2 1 1 2 2 5 5 2 2 1 1
1 1 1 1 5 5 3 3 4 4 2 2 1 1 2 2 1 1 2 2 5 5 2 2 1 1
3 3 2 2 5 5 3 3 1 1 2 2 1 1 2 2 1 1 1 1 5 5 2 2 1 1
3 3 2 2 5 5 3 3 1 1 2 6 6 6 6 2 1 1 1 1 5 5 2 2 1 1
1 1 2 2 5 5 2 2 1 1 2 6 0 0 6 2 1 1 2 2 5 5 2 2 1 1
1 1 2 2 5 5 2 2 1 1 2 6 0 0 6 2 1 1 2 2 5 5 2 2 1 1
1 1 2 2 5 5 5 5 5 5 5 6 6 6 6 5 5 5 5 5 5 5 1 1 1 1
1 1 2 2 5 5 5 5 5 5 5 5 5 5 5 5 5 5 5 5 5 5 1 1 1 1
1 1 2 2 1 1 1 1 1 1 5 5 5 5 5 5 1 1 2 2 1 1 2 2 1 1
1 1 2 2 1 1 1 1 1 1 1 1 1 1 1 1 1 1 2 2 1 1 2 2 1 1
1 1 2 2 1 1 2 2 1 1 1 1 1 1 1 1 1 1 2 2 2 2 2 2 1 1
1 1 2 2 1 1 2 2 1 1 1 1 1 1 1 1 1 1 2 2 2 2 2 2 1 1

